It	PRP
wo	MD
n't	RB
rain	VB
but	CC
there	EX
might	MD
be	VB
snow	NN
on	IN
high	JJ
ground	NN
if	IN
the	DT
temperature	NN
stays	VBZ
about	IN
the	DT
same	JJ
over	IN
the	DT
next	JJ
24	CD
hours	NNS
.	.

