Instead	RB
of	IN
constantly	RB
worrying	VBG
about	IN
funding	NN
,	,
the	DT
faculty	NN
and	CC
students	NNS
can	MD
focus	VB
on	IN
their	PRP$
project	NN
,	,
with	IN
the	DT
exception	NN
of	IN
sponsors	NNS
'	POS
weeks	NNS
,	,
when	WRB
they	PRP
have	VBP
to	TO
convince	VB
companies	NNS
to	TO
start	VB
or	CC
continue	VB
their	PRP$
support	NN
.	.

